NO ./assets/textures/north.xpm
SO ./assets/textures/south.xpm
WE ./assets/textures/west.xpm
EA ./assets/textures/east.xpm

F 220,100,0
C 225,30,0

1111111111111
1000000000001
1000000000001
1000000N00001
1000000000001
1000000000001
1111111111111


• プログラムは、最初の引数として、拡張子が .cub のシーン記述ファイルを受け取る必要があります。
◦ マップは、6 文字のみで構成する必要があります。0 は空きスペース、1 は壁、N、S、E、W はプレイヤーの開始位置と出現方向を表します。
これは、単純な有効なマップです。
111111
100101
101001
1100N1
111111
◦ マップは壁で囲まれている必要があります。そうでない場合は、プログラムはエラーを返します。
◦ マップコンテンツを除き、各要素タイプは 1 行以上の空行で区切ることができます。
◦ 常に最後に配置する必要があるマップコンテンツを除き、各要素タイプはファイル内で任意の順序で設定できます。
◦ マップを除き、要素の各情報タイプは 1 行以上のスペースで区切ることができます。
◦ マップはファイル内の記述通りに解析する必要があります。スペースはマップの有効な部分であり、適切に処理する必要があります。マップのルールに従う限り、あらゆる種類のマップを解析できる必要があります。


主な機能説明
1. 基本的な要素チェック

有効な文字（'0', '1', 'N', 'S', 'E', 'W'）のみを許可
プレイヤーが1人だけ存在することを確認

2. 壁の囲いチェック

マップの上下左右の境界が全て壁（'1'）で囲まれているかチェック
空白文字は無視して実際の境界を確認

3. プレイヤー位置の妥当性

プレイヤーの周囲8方向に空白や境界外がないかチェック
プレイヤーが壁に囲まれた空間内にいることを確認

4. Flood Fill による閉鎖性チェック

プレイヤー位置から開始して、到達可能な全ての空きスペースを探索
マップの境界（空白文字）に到達できる場合はエラー